111111111111111111
1C10C00000C11000C1
100P01001000100101
100101001001110101
1C0001CC10000001E1
111111111111111111