1111111
1E00001
1111001
11C0001
100C001
1000001
1011001
10C0001
1000P01
1111111